60
8
29 28 28 29 29 29 28 28 28 29 29 28 28 29 29 29 28 28 28 29 29 29 29 28 28 29 29 29 29 29 28 28 28 28 29 29 28 28 28 29 28 28 29 29 29 29 28 28 29 29 29 29 28 28 28 29 28 29 28 28
30 17 17 17 17 17 17 17 17 17 17 17 17 17 17 17 17 17 17 17 17 17 17 17 17 17 17 17 17 17 17 17 17 17 17 18 29 19 17 17 17 17 17 17 17 17 17 17 17 17 17 17 17 17 17 17 17 17 18 29
30 0 0 0 0 0 0 0 0 0 0 0 0 0 0 0 0 0 0 0 0 0 0 0 0 0 0 0 0 0 0 0 0 0 0 3 29 4 0 0 0 0 0 0 0 0 0 0 0 0 0 0 0 0 0 0 0 0 3 29
30 9 9 0 0 9 15 0 0 0 0 0 0 0 0 0 0 0 0 0 0 0 0 0 0 0 0 0 0 0 0 0 0 0 0 3 29 4 0 3 22 21 22 4 0 0 0 0 0 0 0 0 0 0 0 0 0 0 3 28
23 23 23 23 23 23 23 4 0 0 0 0 0 0 0 0 0 0 3 22 21 22 4 0 0 0 0 0 0 0 0 0 0 0 0 3 29 22 4 3 29 28 28 4 0 0 0 0 0 0 0 0 0 0 0 0 0 0 3 28
23 23 23 23 23 23 23 21 22 21 21 4 0 3 21 22 4 0 3 29 29 28 4 0 0 0 0 0 0 0 0 0 0 0 0 0 17 17 0 3 29 28 28 4 0 0 0 3 21 4 0 3 22 4 0 3 22 4 3 29
23 23 23 23 24 25 23 29 28 28 29 4 0 3 29 28 4 0 3 29 28 29 4 0 3 22 21 22 4 0 0 3 22 21 21 22 21 21 22 21 28 29 28 4 0 0 0 0 0 0 0 0 0 0 0 0 0 0 3 29
23 23 23 23 27 26 23 28 29 29 28 4 0 3 28 29 4 0 3 28 28 28 4 0 3 28 29 28 4 0 0 3 28 28 29 28 29 29 28 28 28 29 29 23 23 23 23 23 23 23 23 23 23 23 23 23 23 23 23 29