100
9
26 0 0 0 0 0 0 0 0 0 0 0 0 0 0 0 0 0 0 0 0 0 0 0 0 0 0 0 0 0 0 0 0 0 0 0 3 22 22 22 22 22 22 22 22 22 4 0 0 0 0 0 0 0 0 0 13 0 0 0 0 0 0 0 0 0 0 0 0 0 0 0 0 0 0 0 0 0 0 0 0 0 0 0 0 0 0 0 0 0 0 0 0 0 12 0 0 0 0 26
26 0 0 0 0 0 0 0 0 12 0 0 0 0 0 0 0 13 0 0 0 0 0 12 0 0 0 0 0 0 0 0 0 12 0 0 0 17 17 17 17 17 17 17 17 17 0 0 0 12 0 0 0 0 0 0 0 0 0 0 0 0 0 13 0 0 0 0 0 0 0 0 0 0 0 0 0 0 0 0 0 0 12 0 0 0 0 0 0 13 0 0 0 0 0 0 0 0 0 26
26 0 0 0 0 0 0 0 0 0 0 0 0 0 0 0 0 0 0 0 0 0 0 5 0 0 0 0 0 0 0 0 0 0 0 0 0 0 3 22 4 16 3 22 4 0 0 0 0 0 0 0 0 12 0 0 0 0 0 0 0 0 0 0 0 0 0 0 0 0 9 0 10 0 0 0 0 0 12 0 0 0 0 0 0 0 0 0 0 0 0 0 0 0 0 0 13 0 0 26
26 0 0 0 0 12 0 0 0 0 0 0 0 0 0 1 21 2 9 0 0 1 21 21 2 0 0 0 0 0 12 0 0 0 0 13 0 0 23 22 22 22 22 22 25 0 0 0 0 0 0 0 0 0 0 0 5 0 0 0 0 0 0 0 5 0 0 0 0 23 24 24 24 25 0 0 0 0 0 0 0 0 0 0 1 21 2 10 10 10 0 15 0 0 9 0 9 0 0 26
26 0 0 0 0 0 0 0 0 0 0 0 0 0 23 24 22 21 21 21 21 21 22 22 24 25 0 0 0 0 0 0 0 0 0 0 5 0 0 0 0 0 0 0 0 0 0 0 0 11 0 0 0 0 0 1 21 2 0 0 0 23 24 24 24 25 0 0 0 3 22 19 17 17 0 0 0 0 0 0 0 0 0 1 21 22 21 21 21 21 21 21 21 21 21 21 21 21 21 21
26 0 0 0 0 0 0 0 0 0 0 10 0 0 0 17 17 17 18 22 22 4 0 0 0 0 0 0 0 0 0 0 0 0 23 24 24 24 25 0 0 0 0 0 0 0 0 0 1 21 2 10 0 9 1 21 22 4 0 0 0 0 0 0 0 0 0 0 0 3 22 4 0 0 0 0 0 0 0 0 23 24 24 24 22 22 22 22 22 22 17 17 17 17 22 22 22 22 22 22
26 0 5 0 0 11 0 0 0 23 24 24 25 0 0 15 0 0 3 22 22 4 0 0 13 0 0 0 0 1 21 2 0 10 3 22 4 11 0 0 0 0 0 13 0 0 0 23 24 22 24 24 24 24 24 22 22 4 0 0 0 12 0 0 0 0 0 12 0 3 22 4 15 0 11 0 1 21 2 0 3 22 22 22 22 22 22 22 22 0 11 11 11 22 22 22 22 22 22 22
21 21 21 21 21 21 2 0 0 0 0 0 0 0 1 22 4 11 3 22 22 4 0 0 0 0 0 0 3 21 22 24 24 24 24 22 24 21 4 0 0 0 0 0 0 0 0 0 0 0 3 22 22 22 4 0 0 0 0 0 0 0 0 0 0 0 0 0 0 3 22 22 22 22 21 21 21 22 4 0 0 8 22 22 22 22 22 22 22 22 22 22 22 22 22 22 22 22 22 22
22 22 22 22 22 22 4 0 0 0 0 0 0 1 22 22 22 22 22 22 22 22 4 0 0 0 0 0 0 0 0 3 22 22 22 4 0 0 0 0 0 0 0 0 0 0 0 0 0 0 3 22 22 22 22 22 4 0 0 0 0 0 0 0 0 0 0 0 0 3 22 4 0 0 0 0 0 0 0 0 0 8 22 22 22 22 22 22 22 22 22 22 22 22 22 22 22 22 22 22